WWWWWWWWWWWWWWWWWWWWWWWWWWWWWWWWWWWWWW
WBBFFFFBBBBBBBBBBBBBBBBBBBBBFFFFFFFFFW
W WWWWWW  WWWBBBWWWWW    WWWWWWBWWWWWW
W WFGFFWW WWWWWWWWWWWWWW W    GFFFF  W
W BFFFFWW     FFFFFFFFWW W WWBWWWWWW W
W WWWWWWWWWBWWWWWWWWWWWW W WFFGFFFFW W
W           WPBFFF  WWWW W WWWWWWWFW W
WWWWWWWWWWW WWWWWW       WFFFGFFFFFW W
WWWWWWWWWWWWWWWWWWWWWWWW WWWWWBWWWWW W
WWWF      W           C              W
WWWWWWWWW BBBWWWWWWWWWWWWWWWWWWW WWW W
WWFFFWW   WBBBWWFFFFFFFFFFFWWWWW WW FW
WWFWBB  WWWBBBWWFFFFFFFFFFFWWWWW W  FW
WWFWWW WWWWWWBBBFFFFFFFFFFFWWWWW W  FW
WWWWWWGFFFWWWWWWFFFFFFFFFFFWWWWW W  FW
W  FFFFFFFWWWWWWWWWWWWWWWWWWWWWW WW FW
W WWW WW                         WW FW
W WWW WWWWW FFFFFFFFFFFFFFFFWWWWWWW FW
W WWW   G    WWWWWWWWWWWWWWWWFFFFFFFFW
WWFFFFFFFFFFFFFFFFFFFFFFFFFFFFFFFFFFWW
WWWWWWWWWWWWWWWWWWWWWWWWWWWWWWWWWWWWWW
