WWWWWWWWWWWWWWWWWWWWWWWWWWWWWWWWWWWWWW
WFFFWWFWWWWWFFWWFFFWFBFFWWFFFFFFWFFFFW
WBBWWFBFWFWFFFBBFFFBFWFFFWFFFFFFWFFGFW
WFFBFFFFFFBFFFBBWWWWWWWWWWFFFFFFWBBFFW
WFWWWBFBFWWWWWWFFFFFFFWFFFFFFCFFFFWBBW
WFWWWWWWWWWWWWWFFFFFFFWFFFFFFFFFFFWFFW
WFWFWFFFFFWFWWFFWWWWFFWFFFFFFFFFFFWFFW
WFBFFFFGFFFFWWFFWFFWFFWWWWWWWWWWWWWFFW
WFWWWWWWWWBBWWFFWFWWFWWWFFWWFFWWFFWFFW
WFFFFFFFFFFFFWWWWFFWFWFFFFFFFFFFFFBBBW
WFWWWWBWWWWWWWFFWFWWFWWFFFFFFWWWWFWFFW
WFWFFFFFFBFFWWFFBFFWFWWFFWFFWWWWWWWFFW
WFWFWWWBWWFFWWFFBFWWFWWFFFFFFFFWWWWWWW
WFWFWGFFFWFFWWFFWFFWFWWWWWWWWWFWWWWWWW
WFWFWWWWFWFFWWFFWFWWFFFFFBPWFWFFFFFFFW
WBWFFFFBFWFFFFFFWFFWFFFFFWWWFWWWWBWWWW
WFWWWWWWWWFWWWFFWFWWFFFFFFFBFFFBFFFFFW
WFFFFFFFFFFWFBFFWWWWFWWFFFFBFFFBFFFFFW
WWWWFFGFFFFWWWFFFFFFFFFFFFFBFFFBFFFGFW
WWWWWWWWWWWWWWWWWWWWWWWWWWWWWWWWWWWWWW
