WWWWWWWWWWWWWWWWWWWWWWWWWWWWWWWWWWWWWW
WBBFFFFBBBBBBBBBBBBBBBBBBBBBFFFFFFFFFW
WFWWWWWWFFWWWBBBWWWWWFFFFWWWWWWBWWWWWW
WFWFGFFWWFWWWWWWWWWWWWWWFWFFFFGFFFFFFW
WFBFFFFWWFFFFFFFFFFFFFWWFWFWWBWWWWWWFW
WFWWWWWWWWWBWWWWWWWWWWWWFWFWFFGFFFFWFW
WFFFFFFFFFFFWPBFFFFFWWWWFWFWWWWWWWFWFW
WWWWWWWWWWWFWWWWWWFFFFFFFWFFFGFFFFFWFW
WWWWWWWWWWWWWWWWWWWWWWWWFWWWWWBWWWWWFW
WWWFFFFFFFWFFFFFFFFFFFCFFFFFFFFFFFFFFW
WWWWWWWWWFBBBWWWWWWWWWWWWWWWWWWWFWWWFW
WWFFFWWFFFWBBBWWFFFFFFFFFFFWWWWWFWWFFW
WWFWBBFFWWWBBBWWFFFFFFFFFFFWWWWWFWFFFW
WWFWWWFWWWWWWBBBFFFFFFFFFFFWWWWWFWFFFW
WWWWWWGFFFWWWWWWFFFFFFFFFFFWWWWWFWFFFW
WFFFFFFFFFWWWWWWWWWWWWWWWWWWWWWWFWWFFW
WFWWWFWWFFFFFFFFFFFFFFFFFFFFFFFFFWWFFW
WFWWWFWWWWWFFFFFFFFFFFFFFFFFWWWWWWWFFW
WFWWWFFFGFFFFWWWWWWWWWWWWWWWWFFFFFFFFW
WWFFFFFFFFFFFFFFFFFFFFFFFFFFFFFFFFFFWW
WWWWWWWWWWWWWWWWWWWWWWWWWWWWWWWWWWWWWW
