WWWWWWWWWWWWWWWWWWWWWWWWWWWWWWWWWWWWWW
WFFFFFFFFWWWWWWWFFWWFFWWWWWWWWWWWWWWWW
WWWWWWWFFWFWFWFWFGWWGFWFWFWFWFWFWFWFWW
WFFFWFWFFFFFFFFFFWWWWFFFFFFFFGFFFFWFGW
WFWFWFWFFBGBFFFFFWWWWFFWFWFWFFFFFFWWFW
WFWGWFWFFBBBFFFFWWWWWWFWFWFWWWWWFFFWFW
WFWWWFWFFFBFFFFFWWWWWWFFWFWWFFFFFWWWFW
WFBPBFWWWFBFFFFUUGBGGWWFFFFWFBGFFWFFFW
WFWWWFFFFFBFFFFWUGBGGWWFFFFFFBBFFWWWFW
WFWBBFFFFFBBBBWUUGGGGWWWBBBBBBBBFFWFFW
WFFFWFWWWFFFFFWUWWWWWWWWFFFFFFFFFFWFFW
WFBWWFWFWFWFFWWUFWWWWFWWWFFFFFFFFFFFGW
WGBFWFFFWFWFFUUWFFWWFFWWWFFFWWWWWWWWFW
WFBWWFFWWWWFWWUWFFFFFFWWWWFFWFFFGFFWFW
WFBFWFWWWWFFWUUWFFWWFFWWWWFFWFWWWWFWFW
WFBWWFFWWWFWWUUUFWWWWFWWWWWFWFWFFWFWFW
WFFFWFWFWFFWWWWWWWWWWWWWWWWFWFWGWWFWFW
WFWBWFWFFGFFFFBFFFFGFBFFFFFFWFWFFFFWFW
WFFFWFFWWWWFFFBBBFFFFBBBFFFFWFWWWWWWFW
WFFFBFWFFFFFFFFFBFFFFFFBFFFFWFFFFFFFFW
WWWWWWWWWWWWWWWWWWWWWWWWWWWWWWWWWWWWWW
